NO textures/texture3.xpm
SO textures/texture3.xpm
WE textures/texture3.xpm
EA textures/texture3.xpm

F 90,90,90
C 128,128,128


111111111111111111111
100000000000000000001
111000000111111100001
1000000000010001010011111
1100000000000000000000001
1100N00000010001010011111
111111111111111111111
