NO textures/LAB_4A.xpm
WE textures/LAB_5B.xpm
SO textures/LAB_4A.xpm
EA textures/LAB_5B.xpm

F 27,32,32
C 75,85,95  

1111111111111111111111111
1000000000110000000000001
1011000001110000000000001
10100000000000000000000111
111111111011000001110000011
100000000011000001110111011111111
11110111111111011100000000001
11110111111111011101010010001
11000000110101011100000010001
10000000000000001100000010001
10000000000000001101010010001
11000001110101011111011110N0111
1110111 1110101 101111010001
11111111 1111111111111111111