NO ./textures/texture7.xpm

SO ./textures/texture7.xpm

WE ./textures/texture7.xpm

EA ./textures/texture7.xpm

F 100,100,100
C 0,0,139

1111111111111111111111111
1000000000110000000000001
1011000001110000000000001
100100000000000000000000111111111
111111111011000001110000000000001
1000000000110000011101111011111111
11110111111111011100000010001
11110111111111011101010010001
11000000110101011100000010001
10000000000000001100000010001
1000000000000001101010010001
11000001110101011111011110N0111
1 1110111 1110101 101111010001
11111111 1111111 111111111111
